60 40
############################################################
#   #         ##   #              #         ##   #         #
#   ####       #   #####  ####    ## #           #         #
#      #      ##   #         #      ###### ##### #         #
#      #       #      ########## ####       ##   #   #  #  #
#####  #       #####  #   #                 ##       #  #  #
#      # ### ###      #   # ######   #####  ##   #  ####   #
#      #       #   #      #   #      #####  ##   #  ####   #
#      #       #   #   #  ### #              #   #     #   #
## ####### #####   #   #  #   #####         ##   #   #  #  #
## ##          #   #   ####   #   ####      ##   ########  #
#   #     ######   #   #      ##     #####  ##   #  ##     #
#   ####       #   ########      ##  #       #   #     ### #
#      #       #   #         ######  #      ##   #     #   #
#      #####   #   #  ####   #       #   #####   ####  # ###
#####  #       #   #     ### ## ######      ### ##     #   #
#      #   #####   ####  #      ##   #####   #      #  ## ##
#      #       #      #  # ######    #   #  ##   #     #   #
#              #   #     #      # #     ###   #  #  ####   #
##             #   ############ # #### ##### ###           #
##     #########   #      #   # # #          #             #
#   #          #   #   #  # # # # #         ##   ######### #
#   ####       #   #   #  # # # ######       #   #         #
#      ######  #   #   #    #   #   ############ #   #######
#      #       #   #  #############         ##   #   #     #
#####  #       #####  #   #                 ##          #  #
#      # ### ###   #  #   #  #####   #####  ##   #  ####   #
#      ##      ##  #      #  ##      #####  ##   #  ####   #
#      #       #   #   #  #  ##              #   #    #    #
## #############   #   #  #  ######         ##   #  #   #  #
## ##              #   ####       ####      ##   ########  #
#   #  ##### ###   #         ##      #####  ##   #  ##     #
#   ####       #   ########  ######  #       #   #     ### #
#      #   ### #   #         ######  #      ##   #     #   #
#      ##      #   #  ####   #       #   #####   ####  # ###
#####  ##### ###   #     ### #       #      ### ##     #   #
#      #      ##   ####  #   #####   #####   #      #  ## ##
#      #       #      #  # ####      #      ##   #     #   #
#              #   #        #          ###   #   #  ####   #
############################################################